login=LoginServlet
home=HomeServlet
logout=LogoutServlet
update=UpdateServlet
delete=DeleteServlet
invalidPage=invalid.html
searchPage=Search.jsp
signUpPage=signUp.jsp
loginPage=login.jsp
homePage=home.jsp
quizPage=takeAQuiz.jsp
TakeAQuiz=TakeAQuizServlet
subject=SubjectServlet
errorPage=error.html
create=CreateNewAccountServlet
searchRewriting=searchQuestion?
pagenotfound=404.html
showResult=ShowResultsServlet
resultPage=result.jsp
viewHistoryPage=viewHistory.jsp
viewHistory=ViewHistoryServlet
searchHistoryPage=searchHistory.jsp
searchHistory=SearchHistoryServlet
searchQuestion=SearchQuestionServlet
searchQuestionPage=searchQuestion.jsp
getInfoToCreate=GetInfoToCreateServlet
createNewQuestionPage=createNewQuestion.jsp
createNewQuestion=CreateNewQuestionServlet
forward=ForwardServlet
updatePage=update.jsp
getInfoToUpdate=GetInfoToUpdateServlet
